CFO AND CEO	C-Suite
Business consultant	Other
Head of Human Resources	Director
Senior Research Scientist	Other
Head Of Marketing	Director
consultant	Other
Global Benefits Business Process Lead	Manager
Business Promoter	Other
Freelance Martech Consultant	Other
Analytics and AI Market Manager	Manager
Senior Iphone Developer	Other
Software Engineer, Tech lead	Manager
Design Engineer - Pentium® Processor	Other
Web Designer / Illustrator	Other
Game Programmer	Other
iOS Development	Other
Assistant Professor of Psychiatry	Other
CIO Engineering Devops	C-Suite
Senior Services Director	Director
Professor in BioMechanical Engineering	Other
Chief Product Officer at GE Aviation's Digital Group	C-Suite
Vice President Global Head of Product	VP
Group Vice President, Energy and Manufacturing Insights	VP
Finance	Other
Chief Execution Officer	C-Suite
Chief Resources Officer	C-Suite
Chief Scientific Officer	C-Suite
Director of Engineering	Director
Malware Analyst	Other
Head of sales for B2B	Director
Manager for sales	Manager
Manager Pre-sales	Manager
Manager of sales and reservations	Manager
vice president of sales operations	VP
Finance Manager and Data Analyst	Manager
Vice-President	VP
Global Head of Strategy (EVP)	VP
Group Chief Digital Officer	C-Suite
VP of Nintendo China	VP
Transformation Leader	Manager
Co-Founder & software developer	C-Suite
President - Maintenance, Engineering Training Co.	Director
President and Co-Founder	C-Suite
Co-founder	C-Suite
Founder and Technical Director	C-Suite
Co-Executive Director of Mobilizing Causes	Director
CEO/ Web Strategy Producer	C-Suite
CTO / Co-Founder	C-Suite
Quantitative Portfolio Manager/Researcher	Manager
Board member	C-Suite
Manager, Global Digital Innovation	Manager
Head of Technology Marketing	Director
Worldwide iPad Lead	Manager
Senior Advisor	Other
Co-founder & General Director	C-Suite
Co-Founder & VP of Business Development	C-Suite
Publisher and CEO	C-Suite
Chief Marketing and Product Officer	C-Suite
Account Manager	Other
Chief Marketing a& Digital Officer	C-Suite
Managing Director & CFO, Europe	C-Suite
Innovation Director	Director
Vice President, Artificial Intelligence and Analytics Group Offer Leader	VP
Head of Information Security Strategy and Architecture	Director
Founder & General Manager	C-Suite
Head of sales for B2B	Director
Manager for sales	Manager
Manager Pre-sales	Manager
Manager of sales and reservations	Manager
vice president of sales operations	VP
Senior Policy and Information Director	Director
CEO, Vice President, and General Director	C-Suite
Director Group Talent Development	Director
Co-Founder and Chief Strategy Officer	C-Suite
Head, Treasury and Financial Services	Director
Chief Sales Officer (Partner)	C-Suite
Production Technician	Other
Head Of User Experience and Product Design	Director
Principal PM Manager	Manager
Chief Legal Officer and Chief Financial Officer	C-Suite
Sr. Business Systems Analyst	Other
Co-Founder & Senior Software Engineer Manager	C-Suite
Chief Privacy Officer	C-Suite
Graphic Designer	Other
Director Sales, India Key Accounts	Director
Hr	Other
Representative	Other
Founder & Editor-in-Chief	C-Suite
Investment Associate	Other
Director Solutions Consulting	Director
Company sales representative	Other
sales representative	Other
Vice president of worldwide sales	VP
Director of Customer Success Operations	Director
Chief Risk Officer and Managing Director	C-Suite
Senior Business Development Manager	Manager
Co-Founder and VP Business Development	C-Suite
Platform Team Lead	Manager
Co founder,ceo	C-Suite
Co-Founder & CEO	C-Suite
VP, Product Management	VP
Senior Software Engineer	Other
Director of Wholesale Operations	Director
Security Consultant	Other
Manager, Projects and Operations	Manager
Co-Founder/Co-CEO	C-Suite
Principal Software Engineer and Architect	Other
Shipping and Receiving Manager	Manager
Senior Digital Innovation Officer	Other
Head of sales for B2B	Director
Manager for sales	Manager
Manager Pre-sales	Manager
Manager of sales and reservations	Manager
vice president of sales operations	VP
Scientific Consultant & Founder	C-Suite
Founder and Owner	C-Suite
U.S. Senior Advisor	Other
Senior Video Producer and Editor	Other
MSL Director, Oncology and Respiratory, Field Medical Affairs	Director
Head of Brand and Marketing: Consumer and Investment Management	Director
Co Owner, Photographer	C-Suite
Group Managing Director	Director
Global Operations	Other
Group Vice President, Product Strategy	VP
Vice-President Finance	VP
CEO & FOUNDER tại Trùm iWatch	C-Suite
VP, Marketing & Channel Development	VP
Bellevue/Eastside Chapter President	Director
President of Caggiati	Director
Head of Telco sales	Director
Solutions & Strategy Director Latam	Director
CHAIRMAN & MANAGING DIRECTOR	C-Suite
Founder and CCO	C-Suite
Venture Capital Legal Associate	Other
Co-founder,Managing Director & CEO	C-Suite
Head of IoT	Director
CEO & Legal Representative	C-Suite
Head of Global Talent Acquisition	Director
VP Engineering, Integrations	VP
Senior Manager and Head of YouTube Partner Product Solutions EMEA	Director
Head of Global HR IT	Director
Brand Marketing	Other
Talent Acquisition Manager	Manager
VP & Global Head	Director
Head of Pricing and Market Access	Director
Americas CEO	C-Suite
Associate Director	Director
Tax Accountant, Senior Associate	Other
Vice President Operations	VP
Digital Technology Leadership Program	Other
Technical Head	Director
VP Of Sales	VP
Investment Banking	Other
COO, CCO, Partner and Research Analyst	C-Suite
Sr. Product Manager Microsoft 365 Business	Manager
Senior Engineer	Other
Co Founder and Managing Director	C-Suite
Assistant Governor and General Manager Governance and Strategy & Corporate Relations	Manager
Assistant Vice President - Manufacturing	VP
Brand Guidance Domain Lead Company NameKantar	Manager
Senior Account Manager (Home)	Manager
EVP, Chief Medical Officer	VP
IT and IS Manager	Manager
API Developer | Server Admin	Other
senior web developer	Other
Senior Interface and Web Engineer	Other
Discovery engineer	Other
WebObjects Developer	Other
Project Manager, PHP programmer	Other
Client Service	Other
Big Data Engineer	Other
COO & Co-founder	C-Suite
Chief Investments Officer	C-Suite
Co Founder	C-Suite
7 Months	Other
Angel Investor	Other
Vice president, Publisher	VP
Deputy Director of Human Resources	Director
Venture Professional	Other
Head Of Manufacturing	Director
CEO - Arbitranet	C-Suite
Managing Director for Urban Us	Director
President - Northeast Area	Director
CEE Council Member	C-Suite
VP Mobile, Data & Engagement	VP
Linguistic developer @ Parser team	Other
Vice President, Data & Business Development	VP
IoT professional, EMEA Global Black Belt Team, Western Europe	Other
Head of PSA Peugeot Citroen Innovation Cell @Singapore	Director
Developer, Designer, Field Analyst at Open Technology Institute, NAF	Other
Founder -CTO	C-Suite
Global Head of Creator Development & Management	Director
University Dean for Educational Initiatives and CEO of EdPlus at ASU	C-Suite
Constituent Services	Other
Head of Factual Development	Director
Sales Director Europe - Smart City Solutions	Director
Cofounder/Advisor	C-Suite
President - California and Nevada Region	Director
Senior Architect, Cloud Foundry	Other
Chief Executive Officer / Executive Director	C-Suite
Senior Vice President, General Counsel, Allegiance Telecom Company Worldwide	VP
Marketing and business	Other
Net & Windows Azure Team Lead	Manager
World-wide Program Executive	Other
NLP Engineer	Other
Managing Director Italy	Director
VP of Technical Marketing	VP
Search Editor	Other
Sales & Account manager	Manager
Development and Infrastructure Lead	Manager
School of Business - Advisor	Other
Head of Innovation Mapping	Director
SVP, Healthcare	VP
Engagement Team Manager	Manager
Principal at Atmosphere Research	Other
SR VP Media & Public Relations	VP
Analyst - Equity Capital Markets	Other
MTS Software Engineer	Other
Mobile Software Engineer	Other
SI/PI Consultant	Other
Senior DevOps Specialist	Other
Motorcycle clothing and accessories sales	Other
Manager of regional sales	Manager
Bond and derivative sales	Other
Commercial and Advertisign Director responsible for direct and agency sales.	Director
Director of National Sales & Presale Support	Director
Senior UI/UX Designer, Front-end Developer	Other
Grants Staff Member	Other
Social Outreach Manager	Manager
RE200 Mentor	Other
MD and Head of US Capital Markets	Director
Controller and Vice President	VP
Head of Publisher Development	Director
Staff UX Researcher and UX Manager (Seattle/Kirkland)	Other
Inhouse Consultant - Leader Business Support of IoF2020	Manager
CEO + Partner	C-Suite
President and Head of Business Development	Director
Vice President (New Ventures)	VP
Director of Change Management	Director
enior Portfolio Manager, Senior Analyst and Vice President	VP
Reg. Rep II	Other
Senior Manager, Internet Strategy and Services	Manager
Co- Founder, Director of Customer Success	C-Suite
Director, Digital, Growth, GTM Ops	Director
Director of Transaction Services	Director
Assistant General Manager & Chief Administrative Officer	C-Suite
Sales / Marketing (BZ Results)	Other
Art Historian, Translator	Other
Deputy Director, Bureau of Consumer Protection	Director
Shoutlet Product Marketing Manager	Manager
Show Director	Director
Director | Owner	Director
Senior Director for Business Development & Compliance	Director
Online marketing	Other
Vice President, Mergers and Acquisitions	VP
Consulting Engineers	Other
Vice President, Growth Ventures & Innovation	VP
Professor of Clinical Medicine	Other
EVP & Deputy Publisher	VP
Vice President of Worldwide Operations and Quality	VP
Director of Management Control Center	Director
Executive Teams	Other
CHIEF REVENUE OFFICER	C-Suite
GM, Global Field and Partner Marketing	Other
Sr. Manager, Creative Services	Manager
EVP/Managing Director	VP
In-House Corporate Communication	Other
Lab VP, VP of Product Integration (Application Lifecycle Solutions)	VP
Chief Strategy & Innovations Officer	C-Suite
Vice-President International Group	VP
CEO & ounder	C-Suite
Chairman of the Board of Directors - Saint-Gobain Rakennustuotteet Oy	C-Suite
Author and Host	Other
National Managing Partner, Markets and Talent	Other
Digital IC Designer	Other
Chief Engineer	C-Suite
Product & User Experience Director	Director
Founder & Senior Manager	C-Suite
Head Android	Director
Chief Legal Officer, Senior Vice President	VP
Senior Manager of Business Analysts	Manager
Apple Solutions Consultant	Other
Director of Cardiac Catheterization and Interventional Cardiology Laboratories	Director
Medical Educator and a Professor of Pharmacology	Other
Sr. Technical Acquisition Consultant	Other
SVP, Interactive Marketing - America Online	VP
Engineer, Constellation Program	Other
Head, APAC Emerging Markets	Director
Research Scientist & Head of Quantitative and Computational Finance Lab	Other
President & Board Chairman	Director
Chief Financial Officer and Senior VP	VP
Consultant in Obstetrics & Gynaecology	Other
Radiation Oncology Resident	Other
Senior Architect, Cloud Foundry	Other
Principal with Park Venture Advisors	Other
Managing Director, CSO	C-Suite
Interim Marketing Executive	Other
People Operations Coordinator	Other
Mobile Development	Other
Investment Banking Analyst	Other
Analyst	Other
Consulting Engineers	Other
Digital IC Designer	Other
Head of customer direct sales	Director
VP sales , Europe	VP
Regional car salesman	Other
Chief Business Officer	C-Suite
sales	Other
French sales manager	Manager
Aircraft Resale Sales Manager	Manager
